.....................................
.....................................
............####..####...............
............#..#++#..#...............
............#...^....#...............
............##./|\..##...............
............##..|...##...............
............##..|...##...............
............##......##...............
............#...@....#...............
............#..####..#...............
............##########...............
.....................................
.....................................
