##########
#..####..#
#........#
##......##
##......##
##......##
##......##
#........#
#..####..#
##########
